MMMMMMMMMMMMMMMMMMMMMMMMMMMMMMMM
MTTTTTVVTDTRTTTTTTRTTTTTTTTTTTTM
MTPTTTVTTDTTTTTTTTTTTTTTTTVTTTTM
MTRTTTTTTTTVTTDTTTTTTTTTTVVTTTTM
MTTTTTVTTDTRTTTTTTTTTTTTTTTTTTTM
MTTTTTTTTRTTTTTTVTTTTTTTTTTTTTTM
MTTTTTVTTVTRTTTTTTTTTTTTVTTTTTTM
MTTTTTVTTRTTTTTTTDTTTTTTTTTTTTTM
MTTTTTTTTDTRTTTTTTTTTTTTTTTTTTTM
MTTTTTVTTDTRTTTTTTTTTTTTTTTTTTTM
MTTTTTRTTTTTTTTTTTDTRTTTTTTTTTTM
MTTTTTVTTDTRTTTTTTTTTTTTTTTTTTTM
MTTTTTVTTDTRTTTTTTTTTTTTVTTTTTTM
MTTTTRTTTTVTTDTTTTTTTTTTTTTTTTTM
MTTTTTVTTVTRTTTTTTTTTTTDTTTTTTTM
MMMMMMMMMMMMMMMMMMMMMMMMMMMMMMMM