MMMMMMMMMMMMMMMMMMMMMMMMMMMMMMMM
MTTTTTVRMDTRTTTTTTRTTTTTTTTTTTTM
MTPTTTVTMTTTTTTTTTTTTTTTTTVTTDTM
MTRTTTTTMTTVTTDTTTTTTTTTTVVTRRTM
MTTTTTVTMDTRTTTTTTTTTTTTTTTTTTTM
MTTTTTTTTRTTTTTTVTTTTVTTTTTTTTTM
MTTTTTVTTVTRTTTTTVTTTTTTVTTTTTTM
MTTTTTVTTRTTTTTTTDTTTTTTTTTTTTTM
MTTTTTTTTRTRTTTRTTTTTTTVVTTTTTDM
MTTTTTVTTDTDTTTTTVTMTTTTTTTTTTTM
MTTTTTRTTTTTTTTTTTDMRTTTVTTTTTTM
MTTTTTVTTVTRTTTTTTTMTRTTTTVTTTTM
MTTTTTVTTTTRTTTTTTTMTTTTVTTRTTTM
MTTTTRTTTTVTTDTTTTTMTTTTTTVTTTTM
MTTDTTVTTVTRTTTTTTTMTTTDTTTTTTTM
MMMMMMMMMMMMMMMMMMMMMMMMMMMMMMMM