M	M	M	M	M	M	M	M	M	M	M	M	M	M	M	M	M	M	M	M	M	M	M	M	M	M	M	M	M	M	M	M
M	T	T	T	T	T	V	T	T	D	T	R	T	T	T	T	T	T	T	T	T	T	T	T	T	T	T	T	T	T	T	M
M	T	R	P	R	T	T	T	T	T	V	T	T	T	T	T	T	V	T	T	R	R	T	T	T	T	D	T	T	T	T	M
M	T	T	T	T	T	T	T	T	T	V	T	T	R	R	T	T	T	T	R	R	T	T	T	V	V	T	T	T	T	T	M
M	R	T	D	V	T	T	T	R	T	T	T	V	T	D	T	T	T	T	T	T	T	T	R	T	T	T	T	T	R	V	M
M	R	T	R	R	T	T	V	T	T	T	T	V	T	T	T	T	T	T	T	T	T	T	T	R	T	T	T	T	T	V	M
M	M	M	M	M	M	M	M	M	M	M	M	M	M	M	M	M	M	V	T	T	T	T	T	T	T	T	T	R	T	R	M
M	T	T	T	T	T	T	T	T	T	T	T	T	T	T	T	T	T	T	T	R	R	T	T	T	V	T	T	T	T	R	M
M	T	D	R	T	T	T	V	T	T	R	R	T	T	R	T	T	T	T	T	T	T	V	T	T	V	T	R	T	T	T	M
M	T	T	R	T	V	T	T	T	T	T	T	T	T	D	T	T	V	T	T	T	T	T	T	T	T	T	T	T	D	T	M
M	T	T	T	T	T	T	T	T	T	R	M	M	M	M	M	M	M	M	M	M	M	M	M	M	M	M	M	M	M	M	M
M	R	T	R	D	R	T	T	T	D	V	T	T	T	T	R	T	V	T	T	T	T	T	V	T	T	D	T	T	R	T	M
M	T	T	V	R	R	T	V	T	T	T	T	R	T	T	T	T	T	R	T	T	T	T	R	T	T	T	T	V	V	T	M
M	V	T	T	T	T	T	T	T	T	T	T	R	T	T	T	T	T	V	D	T	T	T	R	T	T	T	T	R	T	T	M
M	D	T	T	T	T	T	T	T	T	T	T	R	V	T	T	T	T	T	T	T	V	T	T	T	V	T	T	T	T	T	M
M	M	M	M	M	M	M	M	M	M	M	M	M	M	M	M	M	M	M	M	M	M	M	M	M	M	M	M	M	M	M	M
